{
  "author": "Brainchild Design",
  "description":"The original map of Jump 'n Bump",
  "bgm": "bump.mod",
  "height": 16,
  "width": 22,
  "cell_map":[
    [1, 1, 1, 0, 0, 0, 0, 0, 0, 0, 0, 0, 0, 0, 0, 0, 0, 0, 0, 0, 0, 0],
    [1, 1, 1, 0, 0, 0, 0, 0, 0, 0, 0, 0, 1, 0, 0, 0, 0, 1, 1, 0, 0, 0],
    [1, 1, 0, 0, 1, 1, 1, 1, 0, 0, 0, 0, 1, 1, 0, 0, 0, 0, 0, 0, 0, 0],
    [1, 1, 0, 0, 0, 0, 0, 0, 0, 0, 0, 1, 1, 1, 1, 0, 0, 0, 0, 0, 1, 1],
    [1, 1, 0, 0, 0, 0, 0, 0, 0, 0, 1, 1, 1, 0, 0, 0, 0, 0, 0, 0, 0, 1],
    [1, 1, 1, 0, 0, 0, 1, 1, 1, 1, 1, 1, 0, 0, 0, 0, 0, 0, 0, 0, 0, 1],
    [1, 0, 0, 0, 0, 0, 0, 0, 0, 0, 0, 0, 0, 0, 1, 1, 1, 1, 0, 0, 0, 1],
    [1, 0, 0, 0, 0, 0, 0, 0, 0, 0, 0, 0, 0, 0, 0, 0, 0, 0, 0, 0, 1, 1],
    [1, 1, 1, 0, 0, 1, 1, 1, 0, 0, 0, 0, 0, 0, 0, 0, 0, 0, 0, 1, 1, 1],
    [1, 0, 0, 0, 0, 0, 0, 0, 0, 0, 0, 0, 3, 1, 0, 0, 0, 0, 0, 0, 0, 1],
    [1, 0, 0, 0, 0, 0, 0, 0, 0, 0, 0, 3, 1, 1, 1, 0, 0, 0, 0, 0, 0, 1],
    [1, 0, 1, 1, 1, 1, 0, 0, 0, 0, 3, 1, 1, 1, 1, 1, 1, 1, 1, 0, 0, 1],
    [1, 0, 0, 0, 0, 0, 0, 0, 0, 0, 0, 0, 0, 0, 0, 0, 0, 0, 0, 0, 0, 1],
    [1, 1, 0, 0, 0, 0, 0, 0, 0, 0, 0, 0, 0, 0, 0, 0, 0, 0, 0, 0, 1, 1],
    [2, 2, 2, 2, 2, 2, 2, 2, 1, 4, 0, 0, 0, 0, 0, 1, 3, 3, 3, 1, 1, 1],
    [2, 2, 2, 2, 2, 2, 2, 2, 1, 1, 1, 1, 1, 1, 1, 1, 1, 1, 1, 1, 1, 1]
  ],
  "map_elements": [
    {
      "block_type": "ground",
      "bounding_polygon": [
        {
          "x": 1,
          "y": 1
        },
        {
          "x": 2,
          "y": 1
        },
        {
          "x": 2,
          "y": 2
        },
        {
          "x": 1,
          "y": 2
        }
      ]
    },
    {
      "block_type": "ground",
      "bounding_polygon": [
        {
          "x": 1,
          "y": 15
        },
        {
          "x": 19,
          "y": 15
        },
        {
          "x": 19,
          "y": 16
        },
        {
          "x": 1,
          "y": 16
        }
      ]
    }
  ]
}